################
#..............#
#..............#
#.....####.....#
#.....#..#.....#
#.....#..#.....#
#.....####.....#
#..............#
#..............#
################