##########
#........#
#........#
#........#
#........#
#....#####
#....#
#....#
#....#
######