####################
#..................#
#..................#
#..................#
#.......##.........#
#.......#..........#
#..................#
#..........##......#
#..................#
#..................#
####################